                      NO                ./assets/textures/c_000.xpm        
SO ./assets/textures/c_100.xpm
WE ./assets/textures/c_200.xpm                  
EA  ./assets/textures/c_300.xpm  



 F 30,30,30

C       250,       150,    0





111111111111111111111111111111111
100000001000000000110000000000001
111111111011000001110000000101001
        1001000000010000000010001
111111111011111011100000000000001
100000000011000001110101101111111
1110111111111000000000010001
111101111110000N000010010001
11000000011110000000000010001
10000000000000000000000010001
10000000000101011101010010001
1100000111011101111101111000111
11110111 1110101 101111010001
11111111 1111111 111111111111