                      NO                ./assets/textures/c_000.xpm        
SO ./assets/textures/c_100.xpm
WE ./assets/textures/c_200.xpm                  
EA  ./assets/textures/c_300.xpm  



 F 50,20,20

C       30,       30,    30





111111111111111111111111111111111
100000001000000000110000000000001
111111111011000001110000000000001
        10010000000D0000N00000001
111111111011000001110000000000001
10000000001100000111D1D11D1111111
1110111111111011100000010001
11110111111111011101010010001
110000000110101011100000010001
10000000000000001100000010001
10000000000101001101010010001
1100000111011101111101111000111
11110111 1110101 101111010001
11111111 1111111 111111111111