                      NO                ./assets/textures/00.xpm        
SO ./assets/textures/10.xpm
WE ./assets/textures/20.xpm                   
EA  ./assets/textures/20.xpm   



 F 50,20,20

C       30,       30,    30




111111111111111111111111111111111
1E0000001000000000110000000000001
111111111011000001110000000000001
        1001000000000000000000001
111111111011000001110000000000001
100000000011000001110111111111111
1110111111111011100000010001
11110111111111011101010010001
110000000110101011100000010001
10000000000000001100000010001
10000000000000001101010010001
1100000111010101111101111000111
11110111 1110101 101111010001
11111111 1111111 111111111111






