                      NO ./assets/textures/c_000.xpm        
SO ./assets/textures/c_100.xpm
WE ./assets/textures/c_200.xpm                  
EA              ./assets/textures/c_300.xpm  



F  30,11,                        10          

C 0,0,255


 1111
1N001
10101
11111


