                      NO                ./assets/textures/c_000.xpm        
SO ./assets/textures/c_100.xpm
EA  ./assets/textures/c_300.xpm  



F 30, 30,30

C       250,       150,    0



WE ./assets/textures/c_200.xpm            



111111111111111111111111111111111
10000000100000000011000000000001
1111111111110000011100000001D1001
  111   1D000000000010000000010001
111111111111111D111D1000000000001
10000000001100000111D1D11D1111111
1110111111111000000000010001
1111011111100000000010010001
1100000001111000000E000010001
10000000000D00000000000010001
10000000000101D11101010010001
1100000111011101111101111000111
11110111 1110101 101111010001
11111111 11111111111111111111